#############################
#...........................#
#.##......................#.#
#.........................#.#
#...........................#
#...........................#
#............##.............#
#............##.............#
#...........................#
#...........................#
#...........................#
#.#.........................#
#.#......................##.#
#...........................#
#############################
